10 10
WWWWWWLLLL
WWWWWWLLLL
WWWWWWWLLL
LLWWWWWWLL
LLLLWWWWWL
WWWWWLLWWW
WWWWWLLLWW
WWWWWWLLWW
LLWWWWLLWW
LLLWWWLLWW
