10 10
LLLLLLLLLW
LLLLLLLLWW
LLLLLLLLWW
LLLLLLLLWW
LLLLLLLWWW
WWLLLLWWWL
WWWWWWWWLL
WWWWWWWLLL
WWWWWWLLLL
WWWWWLLLLL
