30 30
WWWWWWWWWWWWWWWWWWWWWWLLLWWWWW
WWWWWWWWWWWWWWWWWWWWWWLLLWWWWW
WWWWWWWWWWWWWWWWWWWWWWLLLLWWWW
WWWWWWWWWWWWWWWWWWWWWWLLLLWWWW
WWWWWWWWWWWWWWWWWWWWWWLLLWWWWW
LLLWWWWWWWWWWWWWWWWWWWLLLWWWWW
LLLLWWWWWWWWWWWWWWWWWWLLLLWWWW
LLLWWWWWWLLWWWWWWWWWWWLLLLWWWW
LLWWWWWWLLLLWWWWWWWWWWWLLWWWWW
WWWWWWWWLLLLLWWWWWWWWWWWWWWWWW
WWWWWWWWLLLLLWWWWWWWWWWWWWWWWW
WWWWWWWWWLLLLLWWWWWWWWWWWWWWWW
WWWWWWWWWWLLLLWWWWWWWWWWWWWWWW
WWWWWWWWWWWLLWWWWWWWWWWWWWWWWW
WWWWWWWWWWWWWWWWWWWWWWWWWWWWWW
WWWWWWWWWWWWWWWWWWWWWWWWWWWWWW
WWWWWWWWWWWWWWWWWWWWWWWWWWWWLL
WWWWWWWWWWLLWWWWWWWWWWWWWWWLLL
WWWWWWWWWLLLLLWWWWWWWWWWWWLLLL
WWWWWWWWWLLLLLLWWWWWWWWWWWLLLL
LWWWWWWWWLLLLLLLWWWWWWWWWWLLLL
LLWWWWWWLLLLLLLLLLLLLLLWWWWLLL
LLLLLLLLLLLLLLWWLLLLLLLLWWWWLL
LLLLLLLLLLLLLWWWWLLLLLLLWWWWLL
LLLLLLLLLLLLWWWWWWLLLLLWWWWWLL
LLLLLLLLLLWWWWWWWWWLLLWWWWWLLL
LLLLWWWLLWWWWWWWWWWLLLWWWWLLLL
LLLWWWWWWWWWWWWWWWWLLLLWWLLLLL
LLWWWWWWWWWWWWLLWWLLLLLLLLLLLL
LLWWWWWWWWWWWLLLLLLLLLLLLLLLLL
